111111111111111111
111000000001111101
100011111100000001
111111111101111111
1C00000000000000C1
101111111011011101
101111111011000001
111111111111111101
111111111000000001
111111111011111111
1E0000000011111111
111111111111111111